NO ./textures/colorstone.xpm

SO ./textures/mossy_1.xpm

WE ./textures/redbrick_1.xpm

EA ./textures/greystone.xpm

S ./textures/greenlight.xpm

C 255,255,204

F 51,51,51

R 1920 1080

111111111111111111
     1111111111
111111100000000111111
1120000000000000000001
100010000000N0000001111
1000100000000000000001
111110000000000001111
     10000000000011111
    100000000000001
111111111111111111
