NO ./textures/colorstone.xpm

SO ./textures/mossy_1.xpm

WE ./textures/redbrick_1.xpm

EA ./textures/greystone.xpm

S ./textures/greenlight.xpm

C 255,255,204

F 51,51,51

R 1920 1080

111111111111111111
     1111111111
111111100000000111111


11111000000000000000111
     100000000N00011111
    100000000000001
111111111111111111
