NO ./textures/colorstone.xpm

SO ./textures/mossy_1.xpm

WE ./textures/redbrick_1.xpm

EA ./textures/greystone.xpm

S ./textures/greenlight.xpm

C 255,255,204

F 51,51,51

R 1920 1080

11111111111111111111
10000000000000000001
10000000000000000001
10000000000000000001
100000000N0000000001
10000000000000000001
10000000000000000001
11111111111111111111
