NO ./textures/colorstone.xpm

SO ./textures/mossy_1.xpm

WE ./textures/redbrick_1.xpm

EA ./textures/greystone.xpm

S ./textures/greenlight.xpm

C 255,255,204

F 51,51,51

R 1920 1080

        1111111111111111111111111
        1000000000110000000000001
        1011000001110000002000001
        1001000000000000000000001
111111111011000001110000000000001
100000000011000001110111111111111
11110111111111011100000000001
11110111111111011101010010001
11000000110101011100000010001
10002000000000001100000010001
10000000000000001101010010001
11000001110101011111011110N0111
11110111111101011101111010001
11111111111111111111111111111
